ADDRESS	AE D R EH S
ADDRESS(2)	AH D R EH S
CANCEL	K AE N S AH L
CONTINUE	K AH N T IH N Y UW
DOWN	D AW N
EMAIL	IY M EY L
GO	G OW
NO	N OW
NUMBER	N AH M B ER
OPTIONS	AA P SH AH N Z
OPTIONS(2)	AO P SH AH N Z
PAUSE	P AO Z
RESET	R IY S EH T
RESTART	R IY S T AA R T
ROOM	R UW M
SLOW	S L OW
START	S T AA R T
STOP	S T AA P
TIMETABLE	T AY M T EY B AH L
WAIT	W EY T
YES	Y EH S
