EIGHT	EY T
FIVE	F AY V
FOUR	F AO R
HELLO	HH AH L OW
HELLO(2)	HH EH L OW
NINE	N AY N
NO	N OW
NUMBER	N AH M B ER
O	OW
ONE	W AH N
ONE(2)	HH W AH N
PATRICK	P AE T R IH K
REZA	R EH Z AH
ROOM	R UW M
SEVEN	S EH V AH N
SIX	S IH K S
THREE	TH R IY
TOM	T AA M
TWO	T UW
YES	Y EH S
ZERO	Z IH R OW
ZERO(2)	Z IY R OW
